1fjdfkd	dlfjldjf
abbreviation	abbreviator
abc	543343
abcoulomb	abcs
abdias	abdicable
abdicate	abdication
abdicator	abdomen
abdominal	abdominalactinomycosis
abdominalaorta	abdominalaorticaneurysm
abdominalbreathing	abdominalcavity
abdominalmuscle	abdominalnerveplexus
abdominalpregnancy	abdominalwall
abdominocentesis	abdominoplasty
abdominous	abdominousness
abdominovesical	abduce
abducens	abducensmuscle
abducensnerve	abducent
abducentnerve	abduct
abducted	abducting
abduction	abductor
abductormuscle	abeam
abecedarian	abecedarius
abed	abel
abelard	abele
abelia	abeliangroup
aberdare	aberdeen
aberdeenangus	aberdonian
aberrance	aberrancy
aberrant	aberrate
aberration	abet
abetalipoproteinemia	abetment
abetter	abettor
abeyance	abeyant
abfarad	abhenry
abhor	abhorrence
abhorrent	abhorrer
abidance	abide
abideby	abiding
abidjan	abience
abient	abies
abiesalba	abiesamabilis
abiesbalsamea	abiesbracteata
abiesconcolor	abiesfraseri
abiesgrandis	abieslasiocarpa
abieslowiana	abiesvenusta
abila	abilene
ability	abiogenesis
abiogenetic	abiogenist
abiotrophy	abject
abjection	abjectly
abjuration	abjure
abkhas	abkhasian
abkhaz	abkhazia
abkhazian	ablactate
ablactation	ablate
ablated	ablation
ablative	ablativeabsolute
ablativecase	ablaut
ablaze	ablazep
able	ablebodied
ablebodiedism	ablebodiedseaman
ablebodism	ableism
ablepharia	ableseaman
ablism	abloom
abls	ablution
ablutionary	ably
